label,n_samples,n_positive,n_negative,n_missing,positive_rate
NR-AR,7265,309,6956,566,0.04253
NR-AR-LBD,6758,237,6521,1073,0.03507
NR-AhR,6549,768,5781,1282,0.11727
NR-Aromatase,5821,300,5521,2010,0.05154
NR-ER,6193,793,5400,1638,0.12805
NR-ER-LBD,6955,350,6605,876,0.05032
NR-PPAR-gamma,6450,186,6264,1381,0.02884
SR-ARE,5832,942,4890,1999,0.16152
SR-ATAD5,7072,264,6808,759,0.03733
SR-HSE,6467,372,6095,1364,0.05752
SR-MMP,5810,918,4892,2021,0.158
SR-p53,6774,423,6351,1057,0.06244
